TTTTTTTTTTTTTTTTTTT22222222TTTTTTTTTTTTTTTTT
T000T00T000TT000000W22W0000T00TT00TTT000000T
T000000000000000000WWWW000000000000T0000T00T
TT011111111111111100WWT000T0T00TT00000T0000T
TT01P00100101000R100WW0000T0000000000000000T
TT01000100D0D0000100WW0T0TTT000000000000000T
T0011D1100101000010TWW0000T0000000000000000T
T0010001111011D11100WWT00000000000000000000T
T001000D000000000D0WWWC00T00000000000000000T
TT010001111D11D1110WWW000000000000000000000T
TT01000100001000010WW0000000000000000000000T
TT01Y00100001000010WW0T00T00000000000000000T
T001111111111111110WW000T000000000000000000T
T000000000000000000WWT0000T0000000000000000T
T00B0B0B0B0B0B0000WWW0000TTT000000000000000T
T00B0B0B0B0B0B000WWWW00T000T000000000000000T
T00B0B0B0B0B0B000WWW0T00000T000000000000000T
T00B0B0B0B0B0B000WW000T0T0T0000000000000000T
TT0B0B0B0B0B0B000WW0T0000000000000000000000T
T000000000000000WWW00T0T00T000000TT000T0000T
T000000000000000WW0T00000000000000T00T00T00T
TT00000000000000WW0000000000000TT0T00000000T
TT00000000000000WW00000000000000T0T0000T000T
T020000000000000WW00000000000000T0TT0TT0000T
2022000000022000WW0020000000000TT00T00T0T00T
2222200022222200WW022200000000TTTT0T0000000T
2222222222222220WW0222222222222222020000020T
2222222222222220WW0222222222222222D22222220T
2222222222222220WW0222200L00022222000022220T
2222222222222220WW0222200WW0022222000022220T
2222222222222220WW0222200WW0022222000022220T
2222222222222220WW022220000002222200002222TT
2222222222222220WW022222200222222220222222TT
2222222222222220WW0022222002222222202222222T
2222222222222220WWW0222220022222222022222222
22222222222222200WW0222220022222222022222222
22222222222222220WW0222220000002220002222222
22222222222222220WWW000000022200000002222222
222222222222222200WW000000022222220002222222
222222222222222200WW222222222222222222222222
222222222222222200WW222222222222222222222222