TTTTTTTTTTTTTTTTTTT22222222TTTTTTTTTTTTTTTTTTTTTTTTTTTTTTTTTTTT
T000T00T000TT000000W22W0000T00TT00TTT000000TTTTTTTTTTTTTTTTTTTT
T000000000000000000WWWW000000000000T0000T00TTTTTTTTTTTTTTTTTTTT
TT011111111111111100WWT000T0T00TT00000T0000TTTTTTTTTTTTTTTTTTTT
TT01P00100101000R100WW0000T0000000000000000TTTTTTTTTTTTTTTTTTTT
TT01000100D0D0000100WW0T0TTT000000000000000TTTTTTTTTTTTTTTTTTTT
T0011D1100101000010TWW0000T0000000000000000TTTTTTTTTTTTTTTTTTTT
T0010001111011D11100WWT00000000000000000000TTTTTTTTTTTTTTTTTTTT
T001000D000000000D0WWWC00T00000000000000000TTTTTTTTTTTTTTTTTTTT
TT010001111D11D1110WWW000000000000000000000TTTTTTTTTTTTTTTTTTTT
TT01000100001000010WW0000000000000000000000TTTTTTTTTTTTTTTTTTTT
TT01Y00100001000010WW0T00T00000000000000000TTTTTTTTTTTTTTTTTTTT
T001111111111111110WW000T000000000000000000TTTTTTTTTTTTTTTTTTTT
T000000000000000000WWT0000T0000000000000000TTTTTTTTTTTTTTTTTTTT
T00B0B0B0B0B0B0000WWW0000TTT000000000000000TTTTTTTTTTTTTTTTTTTT
T00B0B0B0B0B0B000WWWW00T000T000000000000000TTTTTTTTTTTTTTTTTTTT
T00B0B0B0B0B0B000WWW0T00000T000000000000000TTTTTTTTTTTTTTTTTTTT
T00B0B0B0B0B0B000WW000T0T0T0000000000000000TTTTTTTTTTTTTTTTTTTT
TT0B0B0B0B0B0B000WW0T0000000000000000000000TTTTTTTTTTTTTTTTTTTT
T000000000000000WWW00T0T00T000000TT000T0000TTTTTTTTTTTTTTTTTTTT
T000000000000000WW0T00000000000000T00T00T00TTTTTTTTTTTTTTTTTTTT
TT00000000000000WW0000000000000TT0T00000000TTTTTTTTTTTTTTTTTTTT
TT00000000000000WW00000000000000T0T0000T000TTTTTTTTTTTTTTTTTTTT
T020000000000000WW00000000000000T0TT0TT0000TTTTTTTTTTTTTTTTTTTT
2022000000022000WW0020000000000TT00T00T0T00TTTTTTTTTTTTTTTTTTTT
2222200022222200WW022200000000TTTT0T0000000TTTTTTTTTTTTTTTTTTTT
2222222222222220WW0222222222222222020000020TTTTTTTTTTTTTTTTTTTT
2222222222222220WW0222222222222222D22222220TTTTTTTTTTTTTTTTTTTT
2222222222222220WW0222200L00022222000022220TTTTTTTTTTTTTTTTTTTT
2222222222222220WW0222200WW0022222000022220TTTTTTTTTTTTTTTTTTTT
2222222222222220WW0222200WW0022222000022220TTTTTTTTTTTTTTTTTTTT
2222222222222220WW022220000002222200002222TTTTTTTTTTTTTTTTTTTTT
2222222222222220WW022222200222222220222222TTTTTTTTTTTTTTTTTTTTT
2222222222222220WW0022222002222222202222222TTTTTTTTTTTTTTTTTTTT
2222222222222220WWW02222200222222220222222222222222222222222222
22222222222222200WW02222200222222220222222222222222222222222222
22222222222222220WW02222200000022200022222222222222222222222222
22222222222222220WWW0000000222000000022222222222222222222222222
222222222222222200WW0000000222222200022222222222222222222222222
222222222222222200WW2222222222222222222222222222222222222222222
222222222222222200WW2222222222222222222222222222222222222222222
222222222222222200WW2222222222222222222222222222222222222222222
222222222222222200WW2222222222222222222222222222222222222222222
222222222222222200WW2222222222222222222222222222222222222222222
222222222222222200WW2222222222222222222222222222222222222222222
222222222222222200WW2222222222222222222222222222222222222222222
222222222222222200WW2222222222222222222222222222222222222222222
222222222222222200WW2222222222222222222222222222222222222222222
222222222222222200WW2222222222222222222222222222222222222222222
222222222222222200WW2222222222222222222222222222222222222222222
222222222222222200WW2222222222222222222222222222222222222222222
222222222222222200WW2222222222222222222222222222222222222222222
222222222222222200WW2222222222222222222222222222222222222222222
222222222222222200WW2222222222222222222222222222222222222222222
222222222222222200WW2222222222222222222222222222222222222222222
222222222222222200WW2222222222222222222222222222222222222222222
222222222222222200WW2222222222222222222222222222222222222222222
222222222222222200WW2222222222222222222222222222222222222222222
222222222222222200WW2222222222222222222222222222222222222222222
222222222222222200WW2222222222222222222222222222222222222222222
222222222222222200WW2222222222222222222222222222222222222222222
222222222222222200WW2222222222222222222222222222222222222222222
222222222222222200WW2222222222222222222222222222222222222222222
222222222222222200WW2222222222222222222222222222222222222222222